0 : {   10 }
1 : {   12 }
2 : {   13 }
3 : {   14 }
4 : {   15 }
